20 20
####################
#                13#
#                  #
#                  #
#                  #
#                  #
#                  #
#                  #
#                  #
#                  #
#                  #
#                  #
#                  #
#                  #
#                  #
#                  #
#                  #
#                  #
#                  #
####################
10
Box 6 16 8
Box - 16 9
Box 2 16 10
Box * 16 11
Box 8 16 12
Box = 17 13
Player @ 18 13
Box 1 1 17
Box 3 2 18
Player @ 3 18
